日本語	Alts
再び	反復
攻撃	争い
避ける	もがき進む
境界	障壁
体	殻
呼吸	生きる
変える	改変
カオス	無秩序
追跡	追う
文明	政府,都市,構造体
全閉	オールクリア
創造	創造物
創造性	精神,考え,アイデア
情報	信号,メッセージ
悪化	侵食
終わり	閉じる
エンライテンド	悟り
進化	成功
未来	今後
調和	平和
人間	生命
私	自分,自己
精神	アイデア,思考
否	非,欠,内
開	受容
外側	隔たり
完璧	均衡
ポータル	出口,戸口
現在	今
純粋	潔白
リチャージ	修復
レジスタンス	抵抗,苦闘
救う	解放
探求	検索
自己	個人
シェイパー	全体的
心	魂,生命力
安定	動じない,とどまる
私達	我々
あなた	あなたの,他人
